allocator  :   axerrno, bitmap-allocator, slab_allocator
axalloc  :   allocator, axerrno, kspin, memory_addr
axconfig-macros  :   axconfig-gen
axcpu  :   axbacktrace, memory_addr, page_table_entry, percpu
axdriver  :   axalloc, axconfig, axdriver_base, axdriver_block, axdriver_display, axdriver_net, axdriver_pci, axdriver_virtio, axhal, crate_interface
axdriver_block  :   axdriver_base
axdriver_display  :   axdriver_base
axdriver_net  :   axdriver_base
axdriver_pci  :   virtio-drivers
axdriver_virtio  :   axdriver_base, axdriver_block, axdriver_net, virtio-drivers
axerrno  :   axerrno
axfeat  :   axalloc, axbacktrace, axdriver, axfs, axhal, axlog, axnet, axruntime, axsync, axtask
axfs  :   axalloc, axdriver, axerrno, axfs-ng-vfs, axhal, axio, axpoll, axsync, kspin, lwext4_rust, percpu
axfs-ng-vfs  :   axerrno, axpoll
axhal  :   axalloc, axconfig, axcpu, axplat, kernel_guard, memory_addr, page_table_multiarch, percpu
axio  :   axerrno
axlog  :   crate_interface, kspin
axmm  :   axalloc, axconfig, axerrno, axfs, axfs-ng-vfs, axhal, axsync, axtask, kspin, memory_addr, memory_set, page_table_multiarch
axnet  :   axconfig, axdriver, axerrno, axfs, axfs-ng-vfs, axhal, axio, axpoll, axsync, axtask
axplat  :   axplat-macros, crate_interface, kspin, memory_addr, percpu
axruntime  :   axalloc, axbacktrace, axconfig, axdriver, axfs, axhal, axlog, axmm, axnet, axplat, axtask, crate_interface, percpu
axtask  :   axconfig, axerrno, axhal, axpoll, axsched, crate_interface, extern-trait, kernel_guard, kspin, memory_addr, percpu
kernel_guard  :   crate_interface
memory_set  :   axerrno, memory_addr
page_table_entry  :   memory_addr
page_table_multiarch  :   axerrno, memory_addr, page_table_entry
percpu  :   kernel_guard, percpu_macros
slab_allocator  :   buddy_system_allocator
starry  :   axdriver, axerrno, axfeat, axfs, axhal, axlog, axruntime, axsync, axtask, starry-api, starry-core, starry-process, starry-signal
starry-api  :   axalloc, axbacktrace, axconfig, axdisplay, axdriver, axerrno, axfeat, axfs, axfs-ng-vfs, axhal, axio, axlog, axmm, axnet, axpoll, axsync, axtask, kspin, memory_addr, starry-core, starry-process, starry-signal, starry-vm
starry-core  :   axbacktrace, axconfig, axerrno, axfeat, axfs, axfs-ng-vfs, axhal, axio, axlog, axmm, axpoll, axsync, axtask, extern-trait, kernel-elf-parser, kernel_guard, kspin, memory_addr, percpu, starry-process, starry-signal, starry-vm
starry-vm  :   axerrno, extern-trait
